0 0 0 0 0 0 0 0 0 0 0 0 0 0 0 0 0 0 0 0 0 0 31 31 31 31 31 31 31 31 14 10 10 15 31 31 31 31 31 31 31 31 31 31 31 31 31 31 31 31 31 31 31 31 31 31 31 31 31 31 31 31 31 31
0 0 0 0 0 0 0 0 0 0 0 0 0 0 0 0 0 0 0 0 0 3 29 29 29 29 29 30 30 30 14 10 10 15 29 29 29 29 29 29 29 29 29 29 29 29 29 29 29 29 29 29 29 29 29 29 29 29 29 29 29 29 30 30
0 0 0 3 2 2 2 2 2 2 2 2 2 4 0 0 0 3 2 2 2 1 1 1 1 1 1 29 29 29 17 16 16 18 1 1 1 1 1 1 1 1 1 1 1 1 1 1 1 1 1 1 1 1 1 1 1 1 1 1 1 1 29 30
0 0 3 1 1 31 1 1 1 1 1 31 1 1 2 2 2 1 1 1 1 1 1 1 1 1 1 1 1 1 21 20 20 22 8 1 1 1 1 1 1 1 1 1 1 1 1 1 1 1 1 1 1 1 1 1 1 1 1 1 1 1 1 30
0 0 5 1 1 29 1 1 1 1 1 29 1 1 1 1 1 1 1 1 1 1 1 1 54 55 56 1 1 1 24 20 20 22 21 8 7 1 1 1 1 1 1 1 1 1 1 1 1 1 1 1 1 1 1 31 31 1 1 1 1 1 1 30
0 0 5 1 1 1 1 1 36 1 1 1 1 1 1 1 1 1 1 1 1 1 1 1 57 58 59 1 1 1 6 20 20 22 27 21 20 5 1 1 1 1 1 1 1 1 1 1 1 1 1 1 1 1 1 29 29 36 1 1 1 1 1 30
0 0 5 1 1 31 1 1 1 1 1 31 1 1 1 1 1 1 1 1 1 1 1 1 60 61 62 1 1 1 6 26 26 28 0 27 26 5 1 1 1 1 1 1 1 1 1 1 1 1 1 1 1 1 1 1 1 1 1 1 1 1 1 30
0 0 8 1 1 29 1 1 7 1 1 29 1 1 12 11 11 11 11 13 1 1 1 1 1 1 1 1 1 1 6 0 0 0 0 0 0 5 1 1 1 1 1 1 1 1 1 1 1 1 1 1 1 1 1 1 1 1 1 1 1 1 1 30
0 0 21 8 7 7 7 9 20 8 1 1 1 1 14 10 10 10 10 18 1 1 1 1 1 1 1 1 1 1 6 0 0 0 0 0 0 8 7 7 7 7 7 7 7 7 7 7 7 1 1 1 1 1 1 1 1 1 1 1 1 1 1 30
0 0 27 20 20 20 20 22 26 21 5 1 1 1 14 10 10 10 18 22 7 7 7 7 7 7 7 7 7 7 9 0 0 0 0 0 0 21 20 20 20 20 20 20 20 20 20 20 20 8 1 1 1 1 1 1 1 1 1 1 1 1 31 30 
0 0 0 27 26 26 26 28 0 49 1 1 1 1 14 10 10 18 22 22 26 26 26 26 26 26 26 26 26 26 28 0 0 0 0 0 0 27 26 26 26 26 26 26 26 26 26 26 26 26 5 1 1 1 1 1 1 1 31 31 31 31 30 30
0 0 0 0 0 0 0 0 0 5 1 1 1 1 14 10 18 28 0 0 0 0 0 0 0 0 0 0 0 0 0 0 0 0 0 0 0 0 0 0 0 0 0 0 0 0 0 0 0 0 5 1 1 1 1 1 1 1 30 30 30 30 30 30
0 0 0 0 0 0 0 0 0 5 1 1 1 1 14 15 28 0 0 0 0 0 0 0 0 0 0 0 0 0 0 0 0 0 0 0 0 0 0 0 0 0 0 0 0 0 0 0 0 0 5 1 1 1 1 1 1 1 29 30 30 30 30 30
0 0 0 0 0 0 0 0 0 5 1 1 1 12 10 15 0 0 3 2 2 2 2 2 2 2 2 4 0 0 0 0 0 0 0 0 0 0 0 0 0 0 0 0 0 0 0 0 0 0 8 1 1 1 1 1 1 1 1 29 29 30 30 30
0 0 0 0 0 0 0 0 0 5 1 1 1 17 10 15 0 0 5 1 1 1 1 1 1 1 1 6 0 0 0 0 0 0 0 0 3 2 2 2 2 2 2 2 4 0 0 0 0 0 21 8 1 1 1 1 1 1 1 1 1 30 30 30 
0 0 0 0 0 0 0 0 0 5 1 1 1 21 14 15 0 0 5 1 1 1 1 1 1 31 1 6 0 0 0 0 0 0 0 3 1 1 1 37 38 39 1 1 1 4 0 0 0 0 27 21 5 1 1 1 1 1 1 1 1 29 30 30
0 0 0 0 0 0 0 0 0 5 1 1 1 24 14 15 0 0 5 1 36 1 1 1 1 29 1 6 0 0 0 0 0 0 0 5 1 33 1 40 41 42 1 33 1 6 0 0 0 0 0 27 5 1 1 1 1 1 1 1 1 1 30 30
0 0 0 0 0 0 0 0 0 5 1 1 1 1 14 15 0 0 5 1 1 1 1 1 1 1 1 6 0 0 0 0 0 0 0 5 1 32 1 43 44 45 1 32 1 6 0 0 0 0 0 0 5 1 1 1 1 1 1 1 1 1 30 30
0 0 0 0 0 0 0 0 0 5 1 1 1 1 14 15 0 0 5 1 31 1 1 1 1 31 1 6 0 0 0 0 0 0 0 8 1 1 1 46 47 48 1 1 1 9 0 0 0 0 0 0 5 1 1 1 1 1 1 1 1 1 30 30
0 0 0 0 0 0 0 0 0 5 1 1 1 1 14 15 0 0 5 1 29 1 1 1 1 29 1 6 0 0 0 0 0 0 0 21 8 7 1 1 1 1 1 7 9 22 0 0 0 0 0 3 1 1 1 1 1 1 1 1 1 1 30 30
0 0 0 0 0 0 0 0 3 1 1 1 1 1 14 15 0 0 5 1 1 1 1 1 1 1 1 6 0 0 0 0 0 0 0 27 20 20 5 1 1 1 6 20 22 28 0 0 0 0 3 1 1 1 1 1 1 1 1 1 1 1 29 29
0 0 0 0 0 0 0 0 5 1 1 1 1 12 10 10 19 19 11 11 11 13 1 1 1 1 1 6 0 0 0 0 0 0 0 0 27 26 5 1 1 1 6 26 28 0 0 0 0 3 1 1 1 1 1 1 1 1 1 12 11 11 11 13
0 0 0 0 0 0 0 0 5 1 1 1 1 17 16 16 16 16 16 16 16 18 1 1 1 1 1 6 0 0 0 0 0 0 0 0 0 0 5 1 1 1 6 0 0 0 0 0 0 5 1 1 1 1 1 1 1 1 1 17 16 16 10 10
0 0 0 0 0 0 0 0 5 1 1 1 1 21 20 20 20 20 20 35 20 22 1 1 1 1 1 6 0 0 0 0 0 0 3 2 2 2 1 1 1 1 1 2 2 4 0 0 0 5 1 1 1 1 1 1 1 1 1 21 20 35 17 16
0 0 0 0 0 0 0 0 5 1 1 1 1 24 23 23 23 23 23 34 23 25 1 1 1 1 1 6 0 0 0 0 0 0 5 1 1 1 1 1 1 1 1 1 1 6 0 0 0 5 1 1 1 1 1 1 1 1 1 24 23 34 21 20
0 0 0 0 0 0 0 0 5 1 1 1 1 1 1 1 1 1 1 1 1 1 1 1 1 1 1 1 2 4 0 0 0 0 5 1 1 1 1 31 31 1 1 1 1 6 0 0 0 5 1 1 1 1 1 1 1 1 1 1 1 1 24 23
0 0 0 0 0 0 0 0 5 1 1 1 1 1 1 1 1 1 1 1 1 1 1 1 1 1 1 1 1 1 2 2 2 2 1 1 1 1 1 29 29 36 1 1 1 1 2 2 2 1 1 1 1 1 1 1 1 1 1 1 1 1 1 31
0 0 0 0 0 0 0 0 5 1 1 1 1 1 1 1 1 1 1 1 1 1 1 1 1 1 1 1 1 1 1 1 1 1 1 1 1 1 1 1 1 1 1 1 1 1 1 1 1 1 1 1 1 1 1 1 1 1 1 1 1 1 1 30
0 0 0 0 0 0 0 0 8 7 7 7 1 1 1 1 1 1 1 7 7 7 7 1 1 1 1 1 1 1 7 7 7 7 1 1 1 1 1 1 1 1 1 1 1 1 7 7 7 1 1 1 1 1 1 1 1 1 7 7 7 7 1 30
0 0 0 0 0 0 0 0 21 20 20 20 8 7 7 7 7 7 9 20 20 20 20 8 7 7 7 7 7 9 20 20 20 20 8 7 7 7 7 7 7 7 7 7 7 9 20 20 20 8 7 7 7 7 7 7 7 9 20 20 20 20 8 29
0 0 0 0 0 0 0 0 27 26 26 26 21 20 20 20 20 20 22 26 26 26 26 21 20 20 20 20 20 22 26 26 26 26 21 20 20 20 20 20 20 20 20 20 20 22 26 26 26 21 20 20 20 20 20 20 20 22 26 26 26 26 21 20
0 0 0 0 0 0 0 0 0 0 0 0 27 26 26 26 26 26 28 0 0 0 0 27 26 26 26 26 26 28 0 0 0 0 27 26 26 26 26 26 26 26 26 26 26 28 0 0 0 27 26 26 26 26 26 26 26 28 0 0 0 0 27 26
0 0 0 0 0 0 0 0 0 0 0 0 0 0 0 0 0 0 0 0 0 0 0 0 0 0 0 0 0 0 0 0 0 0 0 0 0 0 0 0 0 0 0 0 0 0 0 0 0 0 0 0 0 0 0 0 0 0 0 0 0 0 0 0 