72 72 72 72 72 72 72 72 72 72 72 72 72 72 72 72 72 72 72 72 72 72 72 72 72 72 72 72 72 72 72 72 72 72 72 72 72 72 72 72 72 72 72 72 72 72 72 72 120 122 121 122 121 122 121 122 121 122 121 122 121 122 121 123 72 72 72 72 72 72 72 72 72 72 72 72 72 72 72 72 72
72 72 72 72 72 72 72 72 72 72 72 72 72 72 72 72 72 72 72 72 72 72 72 72 72 72 72 72 72 72 72 72 72 72 72 72 72 72 72 72 72 72 72 72 72 72 72 72 124 127 126 127 126 127 126 127 126 127 126 127 126 127 126 128 72 72 72 72 72 72 72 72 72 72 72 72 72 72 72 72
72 72 72 72 72 72 72 72 72 72 72 72 72 72 72 72 72 72 72 72 72 72 72 72 72 72 72 72 72 72 72 72 72 72 72 72 72 72 72 72 72 72 72 72 72 72 72 72 120 122 121 122 121 122 121 122 121 122 121 122 121 122 121 123 72 72 72 72 72 72 72 72 72 72 72 72 72 72 72 72
72 72 72 72 72 72 72 72 72 72 72 72 72 72 72 72 72 72 72 72 72 72 72 72 72 72 72 72 72 72 72 72 72 72 72 72 72 72 72 72 72 72 72 72 72 72 72 72 124 127 126 127 126 127 126 127 126 127 126 127 126 127 126 128 72 72 72 72 72 72 72 72 72 72 72 72 72 72 72 72
72 72 72 72 72 72 72 72 72 72 72 72 72 72 72 72 72 72 72 72 72 72 72 72 72 72 72 72 72 72 72 72 72 72 72 72 72 72 72 72 72 72 72 72 72 72 72 72 125 116 116 116 116 116 116 116 116 116 116 116 116 116 116 129 72 72 72 72 72 72 72 72 72 72 72 72 72 72 72 72
72 72 72 72 72 72 72 72 72 72 72 72 72 72 72 72 72 72 72 72 72 72 72 72 72 72 72 72 72 72 72 72 72 72 72 72 72 72 72 72 72 72 72 72 72 72 72 72 125 116 116 116 116 116 116 116 116 116 116 116 116 116 116 129 72 72 72 72 72 72 72 72 72 72 72 72 72 72 72 72
72 72 72 72 72 72 72 72 72 72 72 72 72 72 72 72 72 72 72 72 72 72 72 72 72 72 72 72 72 72 72 72 72 72 72 72 72 72 72 72 72 72 72 72 72 72 72 72 125 116 116 116 116 116 116 116 116 116 116 116 116 116 116 129 72 72 72 72 72 72 72 72 72 72 72 72 72 72 72 72
72 72 72 72 72 72 72 72 72 72 72 72 72 72 72 72 72 72 72 72 72 72 72 72 72 72 72 72 72 72 72 72 72 72 72 72 72 72 72 72 72 72 72 72 72 72 72 72 125 116 116 116 116 116 116 116 116 116 116 116 116 116 116 129 72 72 72 72 72 72 72 72 72 72 72 72 72 72 72 72
72 72 72 72 72 72 72 72 72 72 72 72 72 72 72 72 72 72 72 72 72 72 72 72 72 72 72 72 72 72 72 72 72 72 72 72 72 72 72 72 72 72 72 72 72 72 72 72 125 116 116 116 116 116 116 116 116 116 116 116 116 116 116 129 72 72 72 72 72 72 72 72 72 72 72 72 72 72 72 72
72 72 72 72 72 72 72 72 72 72 72 72 72 72 72 72 72 72 72 72 72 72 72 72 72 72 72 72 72 72 72 72 72 72 72 72 72 72 72 72 72 72 72 72 72 72 72 72 125 116 116 116 116 116 116 116 116 116 116 116 116 116 116 129 72 72 72 72 72 72 72 72 72 72 72 72 72 72 72 72
72 72 72 72 72 72 72 72 72 72 72 72 72 72 72 72 72 72 72 72 72 72 72 72 72 72 72 72 72 72 72 72 72 72 72 72 72 72 72 72 72 72 72 72 72 72 72 72 125 116 116 116 116 116 116 116 116 116 116 116 116 116 116 129 72 72 72 72 72 72 72 72 72 72 72 72 72 72 72 72
72 72 72 72 72 72 72 72 72 72 72 72 72 72 72 72 72 72 72 72 72 72 72 72 72 72 72 72 72 72 72 72 72 72 72 72 72 72 72 72 72 72 72 72 72 72 72 72 125 116 116 116 116 116 116 116 116 116 116 116 116 116 116 129 72 72 72 72 72 72 72 72 72 72 72 72 72 72 72 72
72 72 72 72 72 72 72 72 72 72 72 72 72 72 72 72 72 72 72 72 72 72 72 72 72 72 72 72 72 72 72 72 72 72 72 72 72 72 72 72 72 72 72 72 72 72 72 72 125 116 116 116 116 116 116 116 116 116 116 116 116 116 116 129 72 72 72 72 72 72 72 72 72 72 72 72 72 72 72 72
72 72 72 72 72 72 72 72 72 72 72 72 72 72 72 72 72 72 72 72 72 72 72 72 72 72 72 72 72 72 72 72 72 72 72 72 72 72 72 72 72 72 72 72 72 72 72 72 125 116 116 116 116 116 116 116 116 116 116 116 116 116 116 129 72 72 72 72 72 72 72 72 72 72 72 72 72 72 72 72 72
72 72 72 72 72 72 72 72 72 72 72 72 72 72 72 72 72 72 72 72 72 72 72 72 72 72 72 72 72 72 72 72 72 72 72 72 72 72 72 72 72 72 72 72 72 72 72 72 125 116 116 116 116 116 119 116 116 119 116 116 116 116 116 129 72 72 72 72 72 72 72 72 72 72 72 72 72 72 72 72
72 72 72 72 72 72 72 72 72 72 72 72 72 72 72 72 72 72 72 72 72 72 72 72 72 72 72 72 72 72 72 72 72 72 72 72 72 72 72 72 72 72 72 72 72 72 72 72 133 132 132 132 132 132 132 116 116 132 132 132 132 132 132 134 72 72 72 72 72 72 72 72 72 72 72 72 72 72 72 72
72 72 72 72 72 72 72 72 72 72 72 72 72 72 72 72 120 122 121 122 121 122 121 122 121 122 121 122 121 122 121 123 120 122 121 122 121 122 121 122 121 122 121 122 121 122 121 123 120 122 121 122 121 147 121 142 143 122 147 122 121 122 121 123 72 72 72 72 72 72 72 72 72 72 72 72 72 72 72 72
72 72 72 72 72 72 72 72 72 72 72 72 72 72 72 72 124 127 126 127 126 127 126 127 150 127 126 127 126 127 126 128 124 127 126 127 126 127 126 127 126 127 126 127 126 127 126 128 124 127 126 127 126 148 126 144 145 127 148 127 126 127 126 128 72 72 72 72 72 72 72 72 72 72 72 72 72 72 72 72
72 72 72 72 72 72 72 72 72 72 72 72 72 72 72 72 125 116 116 116 116 116 116 116 151 116 116 116 116 116 116 129 125 116 116 116 116 116 116 116 116 116 116 116 116 116 116 129 125 116 116 146 116 149 119 116 116 119 149 116 146 116 116 129 72 72 72 72 72 72 72 72 72 72 72 72 72 72 72 72
72 72 72 72 72 72 72 72 72 72 72 72 72 72 72 72 125 116 116 116 116 116 116 116 152 116 116 116 116 116 116 129 125 116 116 116 116 116 116 116 116 116 116 116 116 116 116 140 139 116 116 146 116 116 116 116 116 116 116 116 146 116 116 129 72 72 72 72 72 72 72 72 72 72 72 72 72 72 72 72
72 72 72 72 72 72 72 72 72 72 72 72 72 72 72 72 125 116 116 116 116 116 116 116 116 116 116 116 116 116 116 116 116 116 116 116 116 116 116 116 116 116 116 116 116 116 119 141 138 119 116 146 146 146 146 146 146 146 146 146 146 116 116 129 72 72 72 72 72 72 72 72 72 72 72 72 72 72 72 72
72 72 72 72 72 72 72 72 72 72 72 72 72 72 72 72 125 116 116 116 116 116 116 116 116 116 116 116 116 116 116 116 116 116 116 116 116 116 116 116 116 116 116 116 116 116 116 116 116 116 116 146 146 146 146 146 146 146 146 146 146 116 116 129 72 72 72 72 72 72 72 72 72 72 72 72 72 72 72 72
72 72 72 72 72 72 72 72 72 72 72 72 72 72 72 72 125 116 116 116 116 116 116 116 116 116 116 116 116 116 116 116 116 116 116 116 116 116 116 116 116 116 116 116 116 116 119 129 125 116 116 116 116 116 116 116 116 116 116 116 116 116 116 129 72 72 72 72 72 72 72 72 72 72 72 72 72 72 72 72
72 72 72 72 72 72 72 72 72 72 72 72 72 72 72 72 125 116 116 116 116 116 116 116 116 116 116 116 116 116 116 129 125 116 116 116 116 116 116 116 116 116 116 116 116 116 116 129 125 119 116 116 116 116 116 116 116 116 116 116 116 116 116 129 72 72 72 72 72 72 72 72 72 72 72 72 72 72 72 72
72 72 72 72 72 72 72 72 72 72 72 72 72 72 72 72 125 116 116 116 116 116 116 116 116 116 116 116 116 116 116 129 125 116 116 116 116 116 116 116 116 116 116 116 116 116 116 129 125 116 116 116 116 116 116 116 116 116 116 116 116 116 116 129 72 72 72 72 72 72 72 72 72 72 72 72 72 72 72 72
72 72 72 72 72 72 72 72 72 72 72 72 72 72 72 72 125 116 116 116 116 116 119 116 116 119 116 116 116 116 116 129 125 116 116 116 116 116 116 116 116 116 116 116 116 116 116 129 125 116 116 116 116 116 116 116 116 116 116 116 116 116 116 129 72 72 72 72 72 72 72 72 72 72 72 72 72 72 72 72
72 72 72 72 72 72 72 72 72 72 72 72 72 72 72 72 133 132 132 132 132 132 132 116 116 132 132 132 132 132 132 134 133 132 132 132 132 132 132 132 132 132 132 132 132 132 132 134 133 132 132 132 132 132 132 132 132 132 132 132 132 132 132 134 133 72 72 72 72 72 72 72 72 72 72 72 72 72 72 72 72
120 122 121 122 121 122 121 122 121 122 121 122 121 122 121 123 120 122 121 122 121 122 121 116 116 122 121 122 121 122 121 123 120 122 121 122 121 122 121 122 121 122 121 122 121 122 121 123 72 72 72 72 72 72 72 72 72 72 72 72 72 72 72 72 72 72 72 72 72 72 72 72 72 72 72 72 72 72 72 72
124 127 126 127 126 127 126 127 126 127 126 127 126 127 126 128 124 127 126 127 126 127 126 116 116 127 126 127 126 127 126 128 124 127 126 127 126 127 126 127 126 127 126 127 126 127 126 128 72 72 72 72 72 72 72 72 72 72 72 72 72 72 72 72 72 72 72 72 72 72 72 72 72 72 72 72 72 72 72 72
125 116 116 116 116 116 116 116 116 116 116 116 116 116 116 129 125 116 117 117 117 117 119 116 116 119 117 117 117 117 116 129 125 116 116 116 116 116 116 116 116 116 116 116 116 116 116 129 72 72 72 72 72 72 72 72 72 72 72 72 72 72 72 72 72 72 72 72 72 72 72 72 72 72 72 72 72 72 72 72
125 116 116 116 116 116 116 116 116 116 116 116 116 116 116 140 139 116 118 136 136 118 116 116 116 116 118 136 136 118 116 140 139 116 116 116 116 116 116 116 116 116 116 116 116 116 116 129 72 72 72 72 72 72 72 72 72 72 72 72 72 72 72 72 72 72 72 72 72 72 72 72 72 72 72 72 72 72 72 72
125 116 116 116 116 136 136 136 136 136 136 116 116 116 119 141 138 119 118 136 136 118 116 116 116 116 118 136 136 118 119 141 138 119 116 136 136 116 116 116 116 116 116 136 136 116 119 129 72 72 72 72 72 72 72 72 72 72 72 72 72 72 72 72 72 72 72 72 72 72 72 72 72 72 72 72 72 72 72 72
125 116 116 116 116 136 116 116 116 116 136 116 116 116 116 116 116 116 116 116 116 116 116 116 116 116 116 116 116 116 116 116 116 116 116 116 116 116 116 116 116 116 116 116 116 116 116 129 72 72 72 72 72 72 72 72 72 72 72 72 72 72 72 72 72 72 72 72 72 72 72 72 72 72 72 72 72 72 72 72
125 116 116 116 116 136 116 116 116 116 136 116 116 116 119 129 125 119 117 117 117 117 116 116 116 116 117 117 117 117 119 129 125 119 116 116 116 116 116 116 116 116 116 116 116 116 119 129 72 72 72 72 72 72 72 72 72 72 72 72 72 72 72 72 72 72 72 72 72 72 72 72 72 72 72 72 72 72 72 72
125 116 116 116 116 136 136 116 116 136 136 116 116 116 116 129 125 116 118 136 136 118 116 116 116 116 118 136 136 118 116 129 125 116 116 136 136 116 116 116 116 116 116 136 136 116 116 129 72 72 72 72 72 72 72 72 72 72 72 72 72 72 72 72 72 72 72 72 72 72 72 72 72 72 72 72 72 72 72 72
125 116 116 116 116 116 116 116 116 116 116 116 116 116 116 129 125 116 118 136 136 118 116 116 116 116 118 136 136 118 116 129 125 116 116 116 116 116 116 116 116 116 116 116 116 116 116 129 72 72 72 72 72 72 72 72 72 72 72 72 72 72 72 72 72 72 72 72 72 72 72 72 72 72 72 72 72 72 72 72
125 116 116 116 116 116 116 116 116 116 116 116 116 116 116 129 125 116 118 118 118 118 119 116 116 119 118 118 118 118 116 129 125 116 116 116 116 116 116 116 116 116 116 116 116 116 116 129 72 72 72 72 72 72 72 72 72 72 72 72 72 72 72 72 72 72 72 72 72 72 72 72 72 72 72 72 72 72 72 72
133 132 132 132 132 132 132 132 132 132 132 132 132 132 132 134 133 132 132 132 132 132 132 116 116 132 132 132 132 132 132 134 133 132 132 132 132 132 132 132 132 132 132 132 132 132 132 134 72 72 72 72 72 72 72 72 72 72 72 72 72 72 72 72 72 72 72 72 72 72 72 72 72 72 72 72 72 72 72 72
120 122 121 122 121 122 121 122 121 122 121 122 121 122 121 123 120 122 121 122 121 122 121 116 116 122 121 122 121 122 121 123 72 72 72 72 72 72 72 72 72 72 72 72 72 72 72 72 72 72 72 72 72 72 72 72 72 72 72 72 72 72 72 72 72 72 72 72 72 72 72 72 72 72 72 72 72 72 72 72
124 127 126 127 126 127 126 127 126 127 126 127 126 127 126 128 124 127 126 127 126 127 126 116 116 127 126 127 126 127 126 128 72 72 72 72 72 72 72 72 72 72 72 72 72 72 72 72 72 72 72 72 72 72 72 72 72 72 72 72 72 72 72 72 72 72 72 72 72 72 72 72 72 72 72 72 72 72 72 72
125 116 116 116 116 116 116 116 116 116 116 116 116 116 116 129 125 116 116 116 116 116 119 116 116 119 116 116 116 116 116 129 72 72 72 72 72 72 72 72 72 72 72 72 72 72 72 72 72 72 72 72 72 72 72 72 72 72 72 72 72 72 72 72 72 72 72 72 72 72 72 72 72 72 72 72 72 72 72 72
125 116 116 116 116 116 116 116 116 116 116 116 116 116 116 116 116 116 116 116 116 116 116 116 116 116 116 116 116 116 116 129 72 72 72 72 72 72 72 72 72 72 72 72 72 72 72 72 72 72 72 72 72 72 72 72 72 72 72 72 72 72 72 72 72 72 72 72 72 72 72 72 72 72 72 72 72 72 72 72
125 116 117 117 117 117 117 117 117 117 117 117 117 117 116 116 116 116 116 116 116 136 136 116 116 136 136 116 116 116 116 129 72 72 72 72 72 72 72 72 72 72 72 72 72 72 72 72 72 72 72 72 72 72 72 72 72 72 72 72 72 72 72 72 72 72 72 72 72 72 72 72 72 72 72 72 72 72 72 72
125 116 118 118 118 118 118 118 118 118 118 118 118 118 116 116 116 116 116 116 116 136 136 116 116 136 136 116 116 116 116 129 72 72 72 72 72 72 72 72 72 72 72 72 72 72 72 72 72 72 72 72 72 72 72 72 72 72 72 72 72 72 72 72 72 72 72 72 72 72 72 72 72 72 72 72 72 72 72 72
125 116 118 118 118 118 118 118 118 118 118 118 118 118 116 116 116 116 116 116 116 136 136 116 116 136 136 116 116 116 116 129 72 72 72 72 72 72 72 72 72 72 72 72 72 72 72 72 72 72 72 72 72 72 72 72 72 72 72 72 72 72 72 72 72 72 72 72 72 72 72 72 72 72 72 72 72 72 72 72
125 116 116 116 116 116 116 116 116 116 116 116 116 116 116 129 125 116 116 116 116 136 136 116 116 136 136 116 116 116 116 129 72 72 72 72 72 72 72 72 72 72 72 72 72 72 72 72 72 72 72 72 72 72 72 72 72 72 72 72 72 72 72 72 72 72 72 72 72 72 72 72 72 72 72 72 72 72 72 72
125 116 116 116 116 116 116 116 116 116 116 116 116 116 116 129 125 116 116 116 116 116 116 116 116 116 116 116 116 116 116 129 72 72 72 72 72 72 72 72 72 72 72 72 72 72 72 72 72 72 72 72 72 72 72 72 72 72 72 72 72 72 72 72 72 72 72 72 72 72 72 72 72 72 72 72 72 72 72 72
125 116 116 116 116 116 116 116 116 116 116 116 116 116 116 129 125 116 116 116 116 116 119 116 116 119 116 116 116 116 116 129 72 72 72 72 72 72 72 72 72 72 72 72 72 72 72 72 72 72 72 72 72 72 72 72 72 72 72 72 72 72 72 72 72 72 72 72 72 72 72 72 72 72 72 72 72 72 72 72
133 132 132 132 132 132 132 116 116 132 132 132 132 132 132 134 133 132 132 132 132 132 132 116 116 132 132 132 132 132 132 134 72 72 72 72 72 72 72 72 72 72 72 72 72 72 72 72 72 72 72 72 72 72 72 72 72 72 72 72 72 72 72 72 72 72 72 72 72 72 72 72 72 72 72 72 72 72 72 72
120 122 121 122 121 122 121 116 116 122 121 122 121 122 121 123 120 122 121 122 121 122 121 116 116 122 121 122 121 122 121 123 120 122 121 122 121 122 121 122 121 122 121 122 121 122 121 123 72 72 72 72 72 72 72 72 72 72 72 72 72 72 72 72 72 72 72 72 72 72 72 72 72 72 72 72 72 72 72 72
124 127 126 127 126 127 126 116 116 127 126 127 126 127 126 128 124 127 126 127 126 127 126 116 116 127 126 127 126 127 126 128 124 127 126 127 126 127 126 127 126 127 126 127 126 127 126 128 72 72 72 72 72 72 72 72 72 72 72 72 72 72 72 72 72 72 72 72 72 72 72 72 72 72 72 72 72 72 72 72
125 116 116 116 116 116 119 116 116 119 116 116 116 116 116 129 125 116 116 116 116 116 119 116 116 119 116 116 116 116 116 129 125 116 116 116 116 116 116 116 116 116 116 116 116 116 116 129 72 72 72 72 72 72 72 72 72 72 72 72 72 72 72 72 72 72 72 72 72 72 72 72 72 72 72 72 72 72 72 72
125 116 116 116 116 116 116 116 116 116 116 116 116 116 116 140 139 116 116 116 116 116 116 116 116 116 116 116 116 116 116 140 139 116 116 136 116 116 116 117 117 116 116 116 136 116 116 129 72 72 72 72 72 72 72 72 72 72 72 72 72 72 72 72 72 72 72 72 72 72 72 72 72 72 72 72 72 72 72 72
125 116 116 136 116 116 136 116 116 136 116 116 136 116 119 141 138 119 116 116 116 116 116 116 116 116 116 116 116 116 119 141 138 119 116 116 116 116 116 118 118 116 116 116 116 116 119 129 72 72 72 72 72 72 72 72 72 72 72 72 72 72 72 72 72 72 72 72 72 72 72 72 72 72 72 72 72 72 72 72
125 116 116 116 116 116 116 116 116 116 116 116 116 116 116 116 116 116 116 116 116 116 116 137 136 116 116 116 116 116 116 116 116 116 116 116 116 116 116 116 116 116 136 116 116 116 116 129 72 72 72 72 72 72 72 72 72 72 72 72 72 72 72 72 72 72 72 72 72 72 72 72 72 72 72 72 72 72 72 72
125 116 116 136 116 116 136 116 116 136 116 116 136 116 119 129 125 119 116 116 116 116 116 116 116 116 116 116 116 116 119 129 125 119 116 116 116 136 116 116 116 116 116 116 116 116 119 129 72 72 72 72 72 72 72 72 72 72 72 72 72 72 72 72 72 72 72 72 72 72 72 72 72 72 72 72 72 72 72 72
125 116 116 116 116 116 116 116 116 116 116 116 116 116 116 129 125 116 116 116 116 116 116 116 116 116 116 116 116 116 116 129 125 116 116 116 116 116 116 117 117 116 116 116 116 116 116 129 72 72 72 72 72 72 72 72 72 72 72 72 72 72 72 72 72 72 72 72 72 72 72 72 72 72 72 72 72 72 72 72
125 116 116 136 116 116 136 116 116 136 116 116 136 116 116 129 125 116 116 116 116 116 116 116 116 116 116 116 116 116 116 129 125 116 116 136 116 116 116 118 118 116 116 116 136 116 116 129 72 72 72 72 72 72 72 72 72 72 72 72 72 72 72 72 72 72 72 72 72 72 72 72 72 72 72 72 72 72 72 72
125 116 116 116 116 116 116 116 116 116 116 116 116 116 116 129 125 116 116 116 116 116 119 116 116 119 116 116 116 116 116 129 125 116 116 116 116 116 116 116 116 116 116 116 116 116 116 129 72 72 72 72 72 72 72 72 72 72 72 72 72 72 72 72 72 72 72 72 72 72 72 72 72 72 72 72 72 72 72 72
133 132 132 132 132 132 132 132 132 132 132 132 132 132 132 134 133 132 132 132 132 132 132 116 116 132 132 132 132 132 132 134 133 132 132 132 132 132 132 132 132 132 132 132 132 132 132 134 72 72 72 72 72 72 72 72 72 72 72 72 72 72 72 72 72 72 72 72 72 72 72 72 72 72 72 72 72 72 72 72
72 72 72 72 72 72 72 72 72 72 72 72 72 72 72 72 120 122 121 122 121 122 121 116 116 122 121 122 121 122 121 123 72 72 72 72 72 72 72 72 72 72 72 72 72 72 72 72 72 72 72 72 72 72 72 72 72 72 72 72 72 72 72 72 72 72 72 72 72 72 72 72 72 72 72 72 72 72 72 72
72 72 72 72 72 72 72 72 72 72 72 72 72 72 72 72 124 127 126 127 126 127 126 116 116 127 126 127 126 127 126 128 72 72 72 72 72 72 72 72 72 72 72 72 72 72 72 72 72 72 72 72 72 72 72 72 72 72 72 72 72 72 72 72 72 72 72 72 72 72 72 72 72 72 72 72 72 72 72 72
72 72 72 72 72 72 72 72 72 72 72 72 72 72 72 72 125 116 116 116 116 116 119 116 116 119 116 116 116 116 116 129 72 72 72 72 72 72 72 72 72 72 72 72 72 72 72 72 72 72 72 72 72 72 72 72 72 72 72 72 72 72 72 72 72 72 72 72 72 72 72 72 72 72 72 72 72 72 72 72
72 72 72 72 72 72 72 72 72 72 72 72 72 72 72 72 125 116 117 117 116 116 116 116 116 116 116 116 117 117 116 129 72 72 72 72 72 72 72 72 72 72 72 72 72 72 72 72 72 72 72 72 72 72 72 72 72 72 72 72 72 72 72 72 72 72 72 72 72 72 72 72 72 72 72 72 72 72 72 72
72 72 72 72 72 72 72 72 72 72 72 72 72 72 72 72 125 116 118 118 116 116 116 116 116 116 116 116 118 118 116 129 72 72 72 72 72 72 72 72 72 72 72 72 72 72 72 72 72 72 72 72 72 72 72 72 72 72 72 72 72 72 72 72 72 72 72 72 72 72 72 72 72 72 72 72 72 72 72 72
72 72 72 72 72 72 72 72 72 72 72 72 72 72 72 72 125 116 116 116 116 116 116 116 116 116 116 116 116 116 116 129 72 72 72 72 72 72 72 72 72 72 72 72 72 72 72 72 72 72 72 72 72 72 72 72 72 72 72 72 72 72 72 72 72 72 72 72 72 72 72 72 72 72 72 72 72 72 72 72
72 72 72 72 72 72 72 72 72 72 72 72 72 72 72 72 125 116 116 116 116 116 116 116 116 116 116 116 116 116 116 129 72 72 72 72 72 72 72 72 72 72 72 72 72 72 72 72 72 72 72 72 72 72 72 72 72 72 72 72 72 72 72 72 72 72 72 72 72 72 72 72 72 72 72 72 72 72 72 72
72 72 72 72 72 72 72 72 72 72 72 72 72 72 72 72 125 116 117 117 116 116 116 116 116 116 116 116 117 117 116 129 72 72 72 72 72 72 72 72 72 72 72 72 72 72 72 72 72 72 72 72 72 72 72 72 72 72 72 72 72 72 72 72 72 72 72 72 72 72 72 72 72 72 72 72 72 72 72 72
72 72 72 72 72 72 72 72 72 72 72 72 72 72 72 72 125 116 118 118 116 116 116 116 116 116 116 116 118 118 116 129 72 72 72 72 72 72 72 72 72 72 72 72 72 72 72 72 72 72 72 72 72 72 72 72 72 72 72 72 72 72 72 72 72 72 72 72 72 72 72 72 72 72 72 72 72 72 72 72
72 72 72 72 72 72 72 72 72 72 72 72 72 72 72 72 125 116 116 116 116 116 119 116 116 119 116 116 116 116 116 129 72 72 72 72 72 72 72 72 72 72 72 72 72 72 72 72 72 72 72 72 72 72 72 72 72 72 72 72 72 72 72 72 72 72 72 72 72 72 72 72 72 72 72 72 72 72 72 72
72 72 72 72 72 72 72 72 72 72 72 72 72 72 72 72 133 132 132 132 132 132 132 116 116 132 132 132 132 132 132 134 72 72 72 72 72 72 72 72 72 72 72 72 72 72 72 72 72 72 72 72 72 72 72 72 72 72 72 72 72 72 72 72 72 72 72 72 72 72 72 72 72 72 72 72 72 72 72 72
120 122 121 122 121 122 121 122 121 122 121 122 121 122 121 123 120 122 121 122 121 122 121 116 116 122 121 122 121 122 121 123 72 72 72 72 72 72 72 72 72 72 72 72 72 72 72 72 72 72 72 72 72 72 72 72 72 72 72 72 72 72 72 72 72 72 72 72 72 72 72 72 72 72 72 72 72 72 72 72
124 127 126 127 126 127 126 127 126 127 126 127 126 127 126 128 124 127 126 127 126 127 126 116 116 127 126 127 126 127 126 128 72 72 72 72 72 72 72 72 72 72 72 72 72 72 72 72 72 72 72 72 72 72 72 72 72 72 72 72 72 72 72 72 72 72 72 72 72 72 72 72 72 72 72 72 72 72 72 72
125 116 116 116 116 116 116 116 116 116 116 116 116 116 116 129 125 116 116 116 116 116 119 116 116 119 116 116 116 116 116 129 72 72 72 72 72 72 72 72 72 72 72 72 72 72 72 72 72 72 72 72 72 72 72 72 72 72 72 72 72 72 72 72 72 72 72 72 72 72 72 72 72 72 72 72 72 72 72 72
125 116 116 116 117 117 116 116 116 116 117 117 116 116 116 140 139 116 116 116 116 116 116 116 116 116 116 116 116 116 116 129 72 72 72 72 72 72 72 72 72 72 72 72 72 72 72 72 72 72 72 72 72 72 72 72 72 72 72 72 72 72 72 72 72 72 72 72 72 72 72 72 72 72 72 72 72 72 72 72
125 116 116 116 118 118 116 116 116 116 118 118 116 116 119 141 138 119 116 116 116 116 116 116 116 116 116 116 116 116 116 129 72 72 72 72 72 72 72 72 72 72 72 72 72 72 72 72 72 72 72 72 72 72 72 72 72 72 72 72 72 72 72 72 72 72 72 72 72 72 72 72 72 72 72 72 72 72 72 72
125 116 116 116 116 116 116 116 116 116 116 116 116 116 116 116 116 116 116 116 116 116 116 116 116 116 116 116 116 116 116 129 72 72 72 72 72 72 72 72 72 72 72 72 72 72 72 72 72 72 72 72 72 72 72 72 72 72 72 72 72 72 72 72 72 72 72 72 72 72 72 72 72 72 72 72 72 72 72 72
125 116 116 116 117 117 116 116 116 116 117 117 116 116 119 129 125 119 116 116 116 116 116 116 116 116 116 116 116 116 116 129 72 72 72 72 72 72 72 72 72 72 72 72 72 72 72 72 72 72 72 72 72 72 72 72 72 72 72 72 72 72 72 72 72 72 72 72 72 72 72 72 72 72 72 72 72 72 72 72
125 116 116 116 118 118 116 116 116 116 118 118 116 116 116 129 125 116 116 116 116 116 116 116 116 116 116 116 116 116 116 129 72 72 72 72 72 72 72 72 72 72 72 72 72 72 72 72 72 72 72 72 72 72 72 72 72 72 72 72 72 72 72 72 72 72 72 72 72 72 72 72 72 72 72 72 72 72 72 72
125 116 116 116 116 116 116 135 116 116 116 116 116 116 116 129 125 116 116 116 116 116 116 116 116 116 116 116 116 116 116 129 72 72 72 72 72 72 72 72 72 72 72 72 72 72 72 72 72 72 72 72 72 72 72 72 72 72 72 72 72 72 72 72 72 72 72 72 72 72 72 72 72 72 72 72 72 72 72 72
133 132 132 132 132 132 132 132 132 132 132 132 132 132 132 134 133 132 132 132 132 132 132 132 132 132 132 132 132 132 132 134 72 72 72 72 72 72 72 72 72 72 72 72 72 72 72 72 72 72 72 72 72 72 72 72 72 72 72 72 72 72 72 72 72 72 72 72 72 72 72 72 72 72 72 72 72 72 72 72