72 72 72 72 72 72 72 72 72 72 72 72 72 72 72 72 72 72 72 72 72 
72 72 72 72 72 72 72 72 72 72 72 72 72 72 72 72 72 72 72 72 72
72 72 72 72 72 72 73 77 78 82 83 78 77 78 78 82 83 77 78 79 72 
72 72 72 72 72 72 74 85 86 85 86 85 64 65 86 85 86 85 86 80 72
72 72 72 72 72 72 75 63 63 63 68 69 66 67 68 69 63 63 63 81 72 
72 72 72 72 72 72 75 63 63 63 70 71 63 63 70 71 63 63 63 81 72 
72 72 72 72 72 72 75 63 63 63 63 63 63 63 63 63 63 63 63 81 72 
72 72 72 72 72 72 75 63 63 63 63 63 63 63 63 63 63 63 63 81 72
72 72 72 72 72 72 75 63 63 63 63 63 63 63 63 63 63 63 63 81 72 
72 72 72 72 72 72 75 63 63 63 63 63 63 63 63 63 63 63 63 81 72 
72 72 72 72 72 72 75 63 63 63 63 63 63 63 63 63 63 63 63 81 72 
72 72 72 72 72 72 76 87 87 87 87 88 63 63 89 87 87 87 87 84 72
72 72 72 72 72 72 72 72 72 72 72 75 63 63 81 72 72 72 72 72 72
72 72 72 72 72 72 72 72 72 72 72 72 72 72 72 72 72 72 72 72 72