72 72 72 72 72 72 72 72 72 72 72 72 72 72 72 72 72 72 72 72 72 
72 72 72 72 72 72 72 72 72 72 72 72 72 72 72 72 72 72 72 72 72
72 72 72 72 72 72 73 78 77 78 77 78 77 78 77 78 77 78 77 79 72 
72 72 72 72 72 72 74 90 91 86 85 86 85 86 85 86 85 86 94 80 72
72 72 72 72 72 72 75 92 93 63 63 63 63 63 63 63 63 63 95 81 72 
72 72 72 72 72 72 75 63 63 63 63 63 63 63 63 63 63 63 63 81 72 
72 72 72 72 72 72 75 63 63 63 63 63 63 63 63 63 63 63 63 81 72 
72 72 72 72 72 72 75 63 63 63 63 63 63 63 63 63 63 63 63 81 72
72 72 72 72 72 72 75 63 63 63 63 63 63 63 63 63 63 63 63 81 72 
72 72 72 72 72 72 75 63 63 63 63 63 63 63 63 63 63 63 63 81 72 
72 72 72 72 72 72 75 63 63 63 63 63 63 63 63 63 63 63 63 81 72 
72 72 72 72 72 72 76 87 87 87 87 88 63 63 89 87 87 87 87 84 72
72 72 72 72 72 72 72 72 72 72 72 75 63 63 81 72 72 72 72 72 72
72 72 72 72 72 72 72 72 72 72 72 72 72 72 72 72 72 72 72 72 72 