72 72 72 72 72 72 72 72 72 72 72 72 72 72 72 72 72 72 72 72 72 72
72 72 72 72 72 72 72 72 72 72 72 72 72 72 72 72 72 72 72 72 72 72
72 72 72 72 72 73 77 78 77 78 77 78 77 78 77 78 77 78 77 78 79 72 
72 72 72 72 72 74 94 86 85 86 85 86 64 65 85 86 85 86 85 94 80 72
72 72 72 72 72 75 95 63 63 63 68 69 66 67 68 69 63 63 63 95 81 72 
72 72 72 72 72 75 63 63 63 63 70 71 63 63 70 71 63 63 63 63 81 72 
72 72 72 72 72 75 63 63 63 63 63 63 63 63 63 63 63 63 63 63 81 72 
72 72 72 72 72 75 63 63 63 63 63 63 63 63 63 63 63 63 63 63 81 72
72 72 72 72 72 75 63 63 63 63 63 63 63 63 63 63 63 63 63 63 81 72 
72 72 72 72 72 75 63 63 63 63 63 63 63 63 63 63 63 63 63 63 81 72 
72 72 72 72 72 75 63 63 63 63 63 63 63 63 63 63 63 63 63 63 81 72 
72 72 72 72 72 76 87 87 87 87 87 88 63 63 89 87 87 87 87 87 84 72
72 72 72 72 72 72 72 72 72 72 72 75 63 63 81 72 72 72 72 72 72 72
72 72 72 72 72 72 72 72 72 72 72 72 72 72 72 72 72 72 72 72 72 72 	