72 72 72 72 72 72 72 72 72 72 72 72 72 72 72 72 72 72 72 72 72 72
72 72 72 72 72 72 72 72 72 72 72 72 72 72 72 72 72 72 72 72 72 72
72 72 72 72 72 73 77 78 77 78 77 78 102 103 77 78 77 78 77 78 79 72 
72 72 72 72 72 74 85 86 85 86 85 86 104 105 85 86 85 86 85 86 80 72
72 72 72 72 72 75 98 98 98 106 108 107 106 106 107 108 107 98 98 98 81 72 
72 72 72 72 72 75 99 99 99 106 109 109 109 109 109 109 106 99 99 99 81 72 
72 72 72 72 72 75 99 99 99 106 109 109 109 109 109 109 106 99 99 99 81 72 
72 72 72 72 72 75 99 99 99 106 109 108 106 106 108 109 106 99 99 99 81 72
72 72 72 72 72 75 106 106 106 106 109 109 109 109 109 109 106 106 106 106 81 72 
72 72 72 72 72 75 96 108 106 106 108 106 109 109 106 108 106 106 108 96 81 72 
72 72 72 72 72 75 96 97 106 106 106 106 109 109 106 106 106 106 97 96 81 72 
72 72 72 72 72 75 96 97 97 97 106 106 109 109 106 106 97 97 97 96 81 72
72 72 72 72 72 75 96 96 96 96 97 106 109 109 106 97 96 96 96 96 81 72
72 72 72 72 72 75 96 96 96 96 97 106 109 109 106 97 96 96 96 96 81 72
72 72 72 72 72 75 96 96 96 96 97 106 109 109 106 97 96 96 96 96 81 72
72 72 72 72 72 75 96 96 96 96 97 106 109 109 106 97 96 96 96 96 81 72
72 72 72 72 72 75 96 96 96 96 96 97 106 106 97 96 96 96 96 96 81 72 
72 72 72 72 72 75 96 96 96 96 96 97 106 106 97 96 96 96 96 96 81 72 
72 72 72 72 72 75 96 110 96 112 113 97 106 106 97 112 113 96 110 96 81 72 
72 72 72 72 72 75 96 111 96 114 115 97 106 106 97 114 115 96 111 96 81 72
72 72 72 72 72 75 96 96 96 96 96 97 106 106 97 96 96 96 96 96 81 72
72 72 72 72 72 75 106 106 106 106 110 97 106 106 97 110 106 106 106 106 81 72 
72 72 72 72 72 75 98 98 98 106 111 97 106 106 97 111 106 98 98 98 81 72 
72 72 72 72 72 75 99 99 99 106 96 97 106 106 97 96 106 99 99 99 81 72 
72 72 72 72 72 75 99 99 99 106 110 97 106 106 97 110 106 99 99 99 81 72
72 72 72 72 72 75 99 99 99 106 111 96 106 106 96 111 106 99 99 99 81 72
72 72 72 72 72 75 99 99 99 106 96 96 96 96 96 96 106 99 99 99 81 72
72 72 72 72 72 76 87 87 87 87 87 100 96 96 101 87 87 87 87 87 84 72 72
72 72 72 72 72 72 72 72 72 72 72 72 72 72 72 72 72 72 72 72 72 72 72 