72 72 72 72 72 72 72 72 72 72 72 72 72 72 72 72 72 72 72 72 72 
72 72 72 72 72 72 72 72 72 72 72 72 72 72 72 72 72 72 72 72 72
72 72 72 72 72 72 73 77 78 82 83 78 77 78 78 82 83 77 78 79 72 
72 72 72 72 72 72 74 85 86 85 86 85 86 85 86 85 86 85 86 80 72
72 72 72 72 72 72 75 98 98 97 96 96 96 96 96 96 97 98 98 81 72 
72 72 72 72 72 72 75 99 99 97 96 96 96 96 96 96 97 99 99 81 72 
72 72 72 72 72 72 75 97 97 97 96 96 96 96 96 96 97 97 97 81 72 
72 72 72 72 72 72 75 96 96 96 96 96 96 96 96 96 96 96 96 81 72
72 72 72 72 72 72 75 96 96 96 96 96 96 96 96 96 96 96 96 81 72 
72 72 72 72 72 72 75 96 96 96 96 96 96 96 96 96 96 96 96 81 72
72 72 72 72 72 72 75 97 97 97 96 96 96 96 96 96 97 97 97 81 72 
72 72 72 72 72 72 75 98 98 97 96 96 96 96 96 96 97 98 98 81 72 
72 72 72 72 72 72 75 99 99 97 96 96 96 96 96 96 97 99 99 81 72  
72 72 72 72 72 72 76 87 87 87 87 100 96 96 101 87 87 87 87 84 72
72 72 72 72 72 72 72 72 72 72 72 72 72 72 72 72 72 72 72 72 72 72